14
1 81 -1 330 91 0 0 0
2 81 -1 426 91 0 0 0
3 81 -1 570 91 0 0 0
4 81 -1 633 76 0 0 0
5 81 -1 762 59 0 0 0
6 81 -1 889 27 0 0 0
7 81 -1 1147 91 0 0 0
8 81 -1 1178 27 0 0 0
9 81 -1 1322 27 0 0 0
10 81 -1 1658 91 0 0 0
11 81 -1 1850 91 0 0 0
12 21 -1 0 370 1536 32 4
13 42 -1 1383 366 10 5 0 
14 42 -1 1441 354 30 14 0



// 21 là Brick
// id 7: object hidden -> vao cua
// id 8: object hidden -> money 

# Phan nao khong can thiet thi dien so 0