51
1 80 -1 330 192 0 0 1
2 80 -1 426 192 0 0 1
3 80 -1 570 192 0 0 1
4 80 -1 633 176 0 0 1
5 80 -1 762 160 0 0 1
6 80 -1 889 128 0 0 1
7 80 -1 1147 192 0 0 1
8 80 -1 1178 128 0 0 1
9 80 -1 1322 128 0 0 1
10 80 -1 1658 192 0 0 1
11 80 -1 1850 192 0 0 1
12 20 -1 16 239 16 16 2
13 20 -1 0 239 548 16 2
14 20 -1 520 239 16 16 2
15 20 -1 576 239 16 16 2
16 20 -1 592 239 16 16 2
17 20 -1 640 239 16 16 2
18 20 -1 656 239 16 16 2
19 20 -1 706 239 16 16 2
20 20 -1 720 239 16 16 2
21 20 -1 768 239 16 16 2
22 20 -1 784 239 16 16 2
23 20 -1 800 208 16 16 2
24 20 -1 816 208 16 16 2
25 20 -1 832 176 16 16 2
26 20 -1 848 176 96 16 2
27 20 -1 944 176 16 16 2
28 20 -1 1024 239 16 16 2
29 20 -1 1040 239 32 16 2
30 20 -1 1072 239 16 16 2
31 20 -1 1120 239 16 16 2
32 20 -1 1136 239 256 16 2
33 20 -1 1392 239 16 16 2
34 20 -1 1216 176 16 16 2
35 20 -1 1232 176 16 16 2
36 20 -1 1280 176 16 16 2
37 20 -1 1296 176 64 16 2
38 20 -1 1360 176 16 16 2
39 20 -1 1408 208 16 16 2
40 20 -1 1424 208 16 16 2
41 20 -1 1440 176 16 16 2
42 20 -1 1456 176 16 16 2
43 20 -1 1472 144 16 16 2
44 20 -1 1488 144 32 16 2
45 20 -1 1520 144 16 16 2
46 20 -1 1600 239 16 16 2
47 20 -1 1664 239 16 16 2
48 20 -1 1728 239 16 16 2
49 20 -1 1792 239 16 16 2
50 20 -1 1808 239 240 16 2
51 20 -1 0 191 16 32 2