50
1 81 -1 330 91 0 0 0
2 81 -1 426 91 0 0 0
3 81 -1 570 91 0 0 0
4 81 -1 633 76 0 0 0
5 81 -1 762 59 0 0 0
6 81 -1 889 27 0 0 0
7 81 -1 1147 91 0 0 0
8 81 -1 1178 27 0 0 0
9 81 -1 1322 27 0 0 0
10 81 -1 1658 91 0 0 0
11 81 -1 1850 91 0 0 0
12 21 -1 16 128 16 16 1
13 22 -1 32 128 496 16 2
14 23 -1 528 128 16 16 3
15 24 -1 576 128 16 16 4
16 25 -1 592 128 16 16 5
17 24 -1 640 128 16 16 4
18 25 -1 656 128 16 16 5
19 24 -1 706 128 16 16 4
20 25 -1 720 128 16 16 5
21 24 -1 768 128 16 16 4
22 25 -1 784 128 16 16 5
23 24 -1 800 96 16 16 4
24 25 -1 816 96 16 16 5
25 24 -1 832 64 16 16 4
26 26 -1 848 64 96 16 6
27 25 -1 944 64 16 16 5
28 24 -1 1024 128 16 16 4
29 26 -1 1040 128 32 16 6
30 25 -1 1072 128 16 16 5
31 27 -1 1120 128 16 16 7
32 22 -1 1136 128 256 16 2
33 23 -1 1392 128 16 16 3
34 24 -1 1216 64 16 16 4
35 25 -1 1232 64 16 16 5
36 24 -1 1280 64 16 16 4
37 26 -1 1296 64 64 16 6
38 25 -1 1360 64 16 16 5
39 24 -1 1408 96 16 16 4
40 25 -1 1424 96 16 16 5
41 24 -1 1440 64 16 16 4
42 25 -1 1456 64 16 16 5
43 24 -1 1472 32 16 16 4
44 26 -1 1488 32 32 16 6
45 25 -1 1520 32 16 16 5
46 28 -1 1600 128 16 16 8
47 28 -1 1664 128 16 16 8
48 28 -1 1728 128 16 16 8
49 27 -1 1792 128 16 16 7
50 22 -1 1808 128 240 16 2

// 21 là Brick
// id 7: object hidden -> vao cua
// id 8: object hidden -> money 

# Phan nao khong can thiet thi dien so 0