50
1 81 -1 330 171 0 0 1
2 81 -1 426 171 0 0 1
3 81 -1 570 171 0 0 1
4 81 -1 633 156 0 0 1
5 81 -1 762 139 0 0 1
6 81 -1 889 107 0 0 1
7 81 -1 1147 171 0 0 1
8 81 -1 1178 107 0 0 1
9 81 -1 1322 107 0 0 1
10 81 -1 1658 171 0 0 1
11 81 -1 1850 171 0 0 1
12 20 -1 16 208 16 16 1
13 20 -1 32 208 496 16 2
14 20 -1 528 208 16 16 3
15 20 -1 576 208 16 16 4
16 20 -1 592 208 16 16 5
17 20 -1 640 208 16 16 4
18 20 -1 656 208 16 16 5
19 20 -1 706 208 16 16 4
20 20 -1 720 208 16 16 5
21 20 -1 768 208 16 16 4
22 20 -1 784 208 16 16 5
23 20 -1 800 176 16 16 4
24 20 -1 816 176 16 16 5
25 20 -1 832 144 16 16 4
26 20 -1 848 144 96 16 6
27 20 -1 944 144 16 16 5
28 20 -1 1024 208 16 16 4
29 20 -1 1040 208 32 16 6
30 20 -1 1072 208 16 16 5
31 20 -1 1120 208 16 16 7
32 20 -1 1136 208 256 16 2
33 20 -1 1392 208 16 16 3
34 20 -1 1216 144 16 16 4
35 20 -1 1232 144 16 16 5
36 20 -1 1280 144 16 16 4
37 20 -1 1296 144 64 16 6
38 20 -1 1360 144 16 16 5
39 20 -1 1408 176 16 16 4
40 20 -1 1424 176 16 16 5
41 20 -1 1440 144 16 16 4
42 20 -1 1456 144 16 16 5
43 20 -1 1472 112 16 16 4
44 20 -1 1488 112 32 16 6
45 20 -1 1520 112 16 16 5
46 20 -1 1600 208 16 16 8
47 20 -1 1664 208 16 16 8
48 20 -1 1728 208 16 16 8
49 20 -1 1792 208 16 16 7
50 20 -1 1808 208 240 16 2